0 0 0 0 0 0 0 0 0 0 0 0 0 0 0 0 0 0 0 0 0
0 S S S S S S S S S 0 S S S S S S S S S 0
0 M 0 0 0 S 0 0 0 S 0 S 0 0 0 S 0 0 0 M 0
0 S S S S S S S S S S S S S S S S S S S 0
0 S 0 0 0 S 0 S 0 0 0 0 0 S 0 S 0 0 0 S 0
0 S S S S S 0 S S S 0 S S S 0 S S S S S 0
0 0 0 0 0 S 0 0 0 S 0 S 0 0 0 S 0 0 0 0 0
0 2 2 2 0 S 0 S S S S S S S 0 S 0 2 2 2 0
0 0 0 0 0 S 0 S 0 0 F 0 0 S 0 S 0 0 0 0 0
P S S S S S S S 0 F F F 0 S S S S S S S S
0 0 0 0 0 S 0 S 0 0 F 0 0 S 0 S 0 0 0 0 0
0 2 2 2 0 S 0 S S S S S S S 0 S 0 2 2 2 0
0 0 0 0 0 S 0 S 0 0 0 0 0 S 0 S 0 0 0 0 0
0 S S S S S S S S S 0 S S S S S S S S S 0
0 S 0 0 0 S 0 0 0 S 0 S 0 0 0 S 0 0 0 S 0
0 S S S 0 S S S S S S S S S S S 0 S S S 0
0 0 0 S 0 S 0 S 0 0 0 0 0 S 0 S 0 S 0 0 0
0 S S S S S 0 S S S 0 S S S 0 S S S S S 0
0 M 0 0 0 0 0 0 0 S 0 S 0 0 0 0 0 0 0 M 0
0 S S S S S S S S S S S S S S S S S S S 0
0 0 0 0 0 0 0 0 0 0 0 0 0 0 0 0 0 0 0 0 0